C-@     : set-mark                                A-&     : tilde-expand
C-a     : beginning-of-line                       A-*     : insert-completions
C-b     : backward-char                           A--     : digit-argument
C-c     : ctrl-c                                  A-.     : yank-last-arg
C-d     : delete-char                             A-0     : digit-argument
C-e     : end-of-line                             A-1     : digit-argument
C-f     : forward-char                            A-2     : digit-argument
C-g     : abort                                   A-3     : digit-argument
C-h     : backward-delete-char                    A-4     : digit-argument
C-i     : clink-completion-shim                   A-5     : digit-argument
C-j     : accept-line                             A-6     : digit-argument
C-k     : kill-line                               A-7     : digit-argument
C-l     : clear-screen                            A-8     : digit-argument
C-m     : accept-line                             A-9     : digit-argument
C-n     : next-history                            A-<     : beginning-of-history
C-p     : previous-history                        A-=     : possible-completions
C-q     : reload-lua-state                        A->     : end-of-history
C-r     : reverse-search-history                  A-?     : possible-completions
C-s     : forward-search-history                  A-\     : delete-horizontal-space
C-t     : transpose-chars                         A-_     : yank-last-arg
C-u     : unix-line-discard                       A-b     : backward-word
C-v     : paste-from-clipboard                    A-c     : capitalize-word
C-w     : unix-word-rubout                        A-d     : kill-word
C-y     : yank                                    A-f     : forward-word
C-z     : undo                                    A-h     : show-rl-help
C-]     : character-search                        A-l     : downcase-word
C-_     : undo                                    A-n     : non-incremental-forward-search-history
A-C-c   : copy-line-to-clipboard                  A-p     : non-incremental-reverse-search-history
A-C-e   : expand-env-vars                         A-r     : revert-line
A-C-g   : abort                                   A-t     : transpose-words
A-C-h   : backward-kill-word                      A-u     : upcase-word
A-C-i   : tab-insert                              A-y     : yank-pop
A-C-j   : vi-editing-mode                         A-~     : tilde-expand
A-C-m   : vi-editing-mode                         C-x,C-g : abort
A-C-r   : revert-line                             C-x,C-r : re-read-init-file
A-C-u   : up-directory                            C-x,C-u : undo
A-C-y   : yank-nth-arg                            C-x,C-x : exchange-point-and-mark
A-C-[   : complete                                C-x,(   : start-kbd-macro
A-C-]   : character-search-backward               C-x,)   : end-kbd-macro
A-      : set-mark                                C-x,e   : call-last-kbdkbd-macro
A-#     : insert-comment